#Reports
Feeling a little peckish: A une petite faim
Feeling hungry: A faim
Suffering from hunger: Souffre de la faim
Is starving to death: Meurs de faim

I'm cold: A froid
I have lost the feeling in my fingers: Ne sens plus ses doigts
I'm frozen: Est gelé
I am dying of cold: Meurs de froid

Excited by new colony: Excité par la nouvelle colonie
In the dark for a long time: Dans le noir depuis longtemps
Feeling lonely: Se sent seul
Need someone to talk: A besoin de parler à quelqu'un

All systems functioning within normal parameters: Tous les systèmes fonctionnent selon des paramètres normaux

#Structure
Door: Porte
Ground: Sol
Floor: Sol
Light: Lumière
Hull: Coque
Wall: Mur
Window: Fenêtre
Hubble: Hublot

#Item
Bed: Lit
Chess tab: Échequier
Pink square: Carré rose
Bedside Table: Table de chevet
Chair: Fauteuil
Chest: Coffre
Desk: Bureau
Wardrobe: Garde robe
Computer: Ordinateur
Laptop: Ordinateur portable
Cooker: Cuisinière
Fridge: Frigo
Pub: Bar
Serving table: Buffet

#Action
None: Aucune
Eat easy meal: Mange un repas simple
Eat advanced meal: Mange un bon repas
Eat military ration: Mange des rations militaires
Cook easy meal: Cuisine un repas simple
Cook advanced meal: Cuisine un bon repas
Cook military ration: Cuisine des rations militaires
Sleep in bed: Dors dans un lit

#Room
Quarter: Quartier
Sickbay: Infirmerie
Garden: Jardin
Storage: Reserve
Enginering: Salle des machines

#Menu
New colony: Nouvelle colonie
Load colony: Charger une colonie
Quit: Quitter

[Monitoring]: [Surveillance]
[Private life]: [Vie privée]
[Priorities]: [Compétences]
[Inventory]: [Inventaire]
[Health]: [Santé]

Resources: Ressources

Food: Nourriture
Entertainment: Divertissement
Gasoline: Essence
Matter: Matériaux
Water: Eau
Power: Énergie
Effects: Effets

Back: Retour
[    ]: [      ]
IN QUEUE: EN ATTENTE

[_BUILD]: [_CONSTRUCTION]
[_CREW]: [_EQUIPAGE]
[_ROOMS]: [_PIECES]
[_MANAGE]: [_GESTION]
[_STATS]: [_STATISTIQUES]
[_PLAN]: [_PLANIFICATION]

"Rendering: %dms": "Temps de rendu: %dms"

#Character
Last reports: Derniers rapports
Monitoring: Surveillance
Staff record: Informations
Inventory: Inventaire
Relationship: Relations
Health: Santé
Security: Sécurité
Energy: Energie
Oxygen: Oxygène
Happiness: Bonheur

#Relations
parent: parent
sister: soeur
half-sister: demi-soeur
brother: frère
half-brother: demi-frère
children: enfant
mate: fiancé

GATHER: RECOLTER
MINING: MINER
DUMP: DÉBARRASSER
PICK UP: PRENDRE
Count: Nombre
Technician: Technicien
Engineer: Ingénieur
Doctor: Docteur
Child: Enfant

I'm starving: Je meurs de faim
I feel lonely: Je me sens seul
Everything goes right: Tout va bien
I sleep well: Je dors bien
bad: mauvais
good: bon

#Build menu
STRUCTURE: _STRUCTURE
QUARTER: _QUARTIER
SICKBAY: _INFIRMERIE
RECREATION: _DIVERTISSEMENT
COMMON: _DIVERS
KITCHEN: _CUISINE
DEFAULT: _DIVERS
SYSTEM: _SYSTÈME
